ایران|ایران کشوری در جنوب غربی آسیا با تاریخ و تمدن کهن
تهران|تهران پایتخت ایران و بزرگترین شهر کشور است
مشهد|مشهد دومین شهر بزرگ ایران و مهمترین شهر مذهبی
اصفهان|اصفهان شهر تاریخی با معماری بی نظیر و پل های زیبا
شیراز|شیراز شهر شعر و ادب با باغ های زیبا و حافظیه
تبریز|تبریز شهر اولین ها با تاریخ غنی و صنعت پیشرفته
اهواز|اهواز مرکز استان خوزستان و شهر نخل و آب
کرج|کرج چهارمین شهر بزرگ ایران در نزدیکی تهران
قم|قم شهر مذهبی و مهمترین مرکز علوم دینی
کرمانشاه|کرمانشاه شهر تاریخ و طبیعت در غرب ایران
ارومیه|ارومیه بزرگترین شهر آذربایجان غربی و دریاچه ارومیه
رشت|رشت مرکز استان گیلان و شهر باران
زاهدان|زاهدان مرکز استان سیستان و بلوچستان
کرمان|کرمان شهر تاریخ و فرهنگ در جنوب شرقی ایران
همدان|همدان شهر تاریخ و تمدن با گنجنامه زیبا
یزد|یزد شهر بادگیرها و معماری خشتی منحصر بفرد
اردبیل|اردبیل شهر طبیعت و آبهای گرم معدنی
بندرعباس|بندرعباس بزرگترین بندر جنوب ایران
سنندج|سنندج مرکز استان کردستان با فرهنگ غنی
زنجان|زنجان شهر مس و هنرهای دستی
خلیج فارس|خلیج فارس آبراه مهم استراتژیک در جنوب ایران
دریای خزر|دریای خزر بزرگترین دریاچه جهان در شمال ایران
دماوند|کوه دماوند بلندترین قله ایران و خاورمیانه
زاگرس|رشته کوه زاگرس مهمترین رشته کوه غرب ایران
البرز|رشته کوه البرز در شمال ایران و محل قله دماوند
کویر لوت|کویر لوت یکی از گرمترین نقاط کره زمین
کویر مرکزی|کویر مرکزی ایران از وسیع ترین کویرهای جهان
کارون|رود کارون طولانی ترین رود ایران
ارس|رود ارس مرز طبیعی ایران و ارمنستان
زاینده رود|زاینده رود مهمترین رود استان اصفهان
هیرمند|رود هیرمند مهمترین رود استان سیستان و بلوچستان
اروند رود|اروند رود مرز طبیعی ایران و عراق
تخت جمشید|تخت جمشید پایتخت ceremonial امپراتوری هخامنشی
پاسارگاد|پاسارگاد نخستین پایتخت شاهنشاهی هخامنشی
چغازنبیل|چغازنبیل نیایشگاه ایلامی در خوزستان
بیستون|کتیبه بیستون بزرگترین سنگ نوشته جهان
نقش رستم|نقش رستم آرامگاه پادشاهان هخامنشی
شیخ صفی الدین|آرامگاه شیخ صفی الدین در اردبیل
باغ ارم|باغ ارم شیراز از زیباترین باغ های ایران
باغ فین|باغ فین کاشان با معماری منحصر بفرد
گنبد سلطانیه|گنبد سلطانیه بزرگترین گنبد آجری جهان
مسجد جامع اصفهان|مسجد جامع اصفهان موزه هنر اسلامی
مسجد شیخ لطف الله|مسجد شیخ لطف الله با کاشیکاری بی نظیر
مسجد امام|مسجد امام اصفهان از شاهکارهای معماری
علیقاپو|کاخ عالیقاپو با تالار موسیقی منحصر بفرد
چهلستون|کاخ چهلستون با آیینه کاری و نقاشی های زیبا
هشت بهشت|کاخ هشت بهشت از کاخ های زیبای صفوی
نقش جهان|میدان نقش جهان از بزرگترین میدان های جهان
برج آزادی|برج آزادی نماد تهران و معماری مدرن ایرانی
برج میلاد|برج میلاد بلندترین برج ایران در تهران
پل خواجو|پل خواجو از زیباترین پل های تاریخی اصفهان
پل سی و سه پل|سی و سه پل از مشهورترین پل های ایران
کاخ گلستان|کاخ گلستان از آثار ثبت شده در یونسکو
بازار تهران|بازار تهران بزرگترین بازار سرپوشیده جهان
بازار اصفهان|بازار اصفهان از قدیمی ترین بازارهای ایران
بازار تبریز|بازار تبریز بزرگترین بازار سرپوشیده جهان
حمام گنجعلی خان|حمام گنجعلی خان کرمان با معماری زیبا
مدرسه چهارباغ|مدرسه چهارباغ اصفهان از زیباترین مدارس
کاروانسرای مهیار|کاروانسرای مهیار از بناهای تاریخی
یخچال میبد|یخچال میبد از سازه های سنتی ذخیره یخ
آتشکده یزد|آتشکده یزد از مهمترین آتشکده های زرتشتی
قنات گناباد|قنات گناباد از قدیمی ترین قنات های جهان
شهر سوخته|شهر سوخته از پیشرفته ترین شهرهای باستانی
میمند|روستای میمند از کهن ترین سکونتگاه های بشری
ماسوله|روستای ماسوله با معماری پلکانی منحصر بفرد
ابیانه|روستای ابیانه با خانه های سرخ و فرهنگ خاص
هوتک|روستای هوتک از روستاهای تاریخی کرمان
کنگ|روستای کنگ با معماری پلکانی در نزدیکی مشهد
ورزنه|ورزنه شهر کویری با فرهنگ غنی در اصفهان
مروارید|مروارید خلیج فارس از زیباترین جزایر ایران
کیش|جزیره کیش از مهمترین مقاصد گردشگری ایران
قشم|جزیره قشم بزرگترین جزیره خلیج فارس
هرمز|جزیره هرمز با خاک های رنگی و طبیعت منحصر بفرد
لارک|جزیره لارک با طبیعت بکر و آب های زلال
هنگام|جزیره هنگام با دلفین های بازیگوش
لاوان|جزیره لاوان از جزایر مهم نفتی ایران
تانگستان|جزیره تانگستان با طبیعت خاص و نادر
شیدور|جزیره شیدور پناهگاه حیات وحش
فارور|جزایر فارور با طبیعت بکر و دست نخورده
نسار|جزیره نسار از جزایر کوچک خلیج فارس
مغان|دشت مغان از حاصلخیزترین دشت های ایران
قرخلو|دشت قرخلو با طبیعت زیبا در آذربایجان
کوهرنگ|کوهرنگ از مناطق خوش آب و هوا در چهارمحال
دنا|کوه دنا از بلندترین رشته کوه های زاگرس
سبلان|کوه سبلان سومین قله بلند ایران
علم کوه|علم کوه دومین قله بلند ایران
تفتان|کوه تفتان تنها آتشفشان نیمه فعال ایران
سهند|کوه سهند از کوه های آتشفشانی ایران
بزمان|کوه بزمان از کوه های آتشفشانی جنوب شرق
الوند|کوه الوند از کوه های زیبای همدان
بینالود|کوه بینالود از کوه های مشهور خراسان
شیرکوه|کوه شیرکوه از کوه های مرتفع یزد
گرین|کوه گرین از کوه های زاگرس مرکزی
پلنگان|کوه پلنگان با طبیعت بکر در لرستان
قالی کوه|قالی کوه از کوه های زیبای آذربایجان
بمو|کوه بمو در نزدیکی شیراز
خواجو|کوه خواجو با چشم انداز زیبا در شیراز
